0000000000000000000000000000
0000000000000000000000000000
0000000000000000000000000000
0111111111111111111111111110
0100010010001001000100100010
0111111011111001111101111110
0101101110010000100111011010
0100100111011111101110010010
0111111101111001111011111110
0100011100101111010011100010
0111110111100110011110111110
0100110010111111110100110010
0110111110010000100111110110
0111101111111111111111011110
0101100101111111111010011010
0100111100100000010011110010
0111101111100000011111011110
1100100101100000011010010011
0110111100100000010011110110
0111101111111111111111011110
0100100100010000100010010010
0110111111111111111111110110
0111101100010000100011011110
0101100111111111111110011010
0100111101100110011011110010
0111100100110110110010011110
0101110111111111111110111010
0100111100101111010011110010
0111101110100110010111011110
0101100111111111111110011010
0100111100010000100011110010
0111111111111111111111111110
0111111111111111111111111110
0000000000000000000000000000
0000000000000000000000000000
0000000000000000000000000000
